      *
*
       

*      *

 
         *

   *    

      *      *

*
      *

   *    

          *       *

*
      *

   *    

     *       *

*
      *

   *    

*       *     *
      *
*
       

*      *

 
         *

   *    
      *
*
       

*      *

 
         *

   *    

      *      *

*
      *

   *    

          *       *

*
      *

   *    

     *       *

*
      *

   *    

*            *       *
      *
*
       

*      *

 
         *

   *    

      *      *

*
      *

   *    

          *       *

*
      *

   *    

     *       *

*
      *

   *    

*     *          *
           *
*
       

*      *

 
         *

   *    

      *      *

*
      *

   *    

          *       *

*
       *

   *    
 
       *       *

*
      *

   *    

*     *    *

*      *
 
    *      *      *                         *
  
*      *    *         *             *   *      *    *        **    *
 
*******  **   *   **      ** *   * *                   * *    * * * *****       ** ** *    *